1111111111111111111111111111111111
1E0000000000000C10000C000000000001
10100101V0100000001001000000010101
10100100101010100010010000V0010101
1P00000000C00C0000000C000000000001
1000000000000000100000000000000001
111111001111111111111111111100C111
11111100111111111111111111110C1111
100000000000000C00000C000000000001
1010010100100000101001000000010101
1010010010101010001001000000010101
1100000000C00C0000000C000000000001
10000000000V00000000000000000000V1
1111111111111111111111111111111111
