111111111111111111111111111111
1P0000000100000000000000000001
100000000100000000000000000001
100000000111111111111111111111
100000000000000000000000000001
10000000010000000000000C000001
100000000100000000000000000001
100000000100000000000000000001
100000000100000C00000000000001
100000000000000000000000000001
100000000000000000000000000001
100000000100000000000000000001
100000000100000000000000000001
100000000100000000000000000001
10000C0001000000000000000000E1
111111111111111111111111111111
